Download => baixar dados da internet;
Upload => mandar dados para a internet;
Navegador =>navegar na internet;
Banda larga => tipo de conexão;
Cache => memória / informações previamente salvas;
Crack => forma de piratiar;
Email => correiro eletrônico;
Emoticons/emoji => figuras;
Gif/jpg/png => formatos de imagens;
Host => servidor;
HTML => linguaguem de marcação;
HTTP => protocolo;
Ícones => figura representativa;
Link => ligação;
URL => endereço;
Login/logon => acesso;
Logout/logoff => desconecta;
Mp3 => formato de música;
Multimídia => diversos tipos de mídias;
Nick => nome de usuário;
Online => conectado;
Ofline => desconectado;
Pixel => junção de palavras (picture + element); menor unidade de uma imagem digital;
Spam => email que são enviados para várias pessoas (marketing);
Vírus => software malicioso com o objetivo de causar um dano;
    Keylogger => vírus que se instala na máquina. Lê tudo que é digitado no teclado;
    Phishing => roba dados enganado outras pessoas. exemplo: email falso de banco.
Backup => cópia de segurança;
Blog => diário (início) - site (atual);
Vlog => blog em forma de vídeo
Cyber/bullying => ameaças/ xingamentos...;
3G/4G/5G => velocidades da internet móvel;
Cookies => registro das ações no site;
Firewall => parede que impede acesso indevido no PC;
Hacker => explora sistemas computacionais (vê sua vulnerabilidade)
Ip => identidade de tudo que esta conectado na rede;
Click bait => "notícias" com função de click; exemplo: clicar em email com vírus;
Fake news => informações falsas que podem vim ou não junto com algum vírus;
Podcast => programa de rádio na internet;
Pop-up => caixas de informações (publicidades/propragandas) nos sites;
Youtuber => profisional que trabalha produzindo conteúdo para o youturbe.
